11111111111111111111111
1E0000000000000C00000C1
10100101C01000001010011
10100101001000001010011
101001010010C0001010011
10100101001000001010011
101001010010000010100C1
10100101001000001010001
10100100101010100010001
1P0000000C00C0000000001
11111111111111111111111