11111111111111111111
1E000C000000000C0001
10100001001000001011
10100101001000001011
10100101001000001011
101C0101001000C01011
10100101001000001011
101001010C1000001011
10100100101010100011
1P0000000C00C0000001
11111111111111111111