1111111111111
1011000001001
100000000C101
10C0000000001
1000011111001
1P0011E00C101
1111111111111