1111111111111
100100C0001C1
1C00011111011
1P0011E000001
1111111111111